00000000000000000000000000000000000200020002000000000000000000000000000000000000000000000000000000000000000000000000000000000000000000 
00000000000000000000000000000000000200020002000000000000000000000000000000000000000000000000000000000000000000000000000000000000000000 
00000000000000000000000000000000000200020002000000000000000000000000000000000000000000000000000000000000000000000000000000000000000000 
01000000000000000000000000000000000200020002000000000000000000000000000000000000000000000000000000000000000000000000000000000000000000 
00000000000000000000000000000000000200020002000000000000000000000000000000000000000000000000000000000000000000000000000000000000000000 
00000000000000000000000000000000000200000002000000000000000000000000000000000000000000000000000000000000000000000000000000000000000000 
00000000000000000000000000000000000000000000000000000000000000000000000000000000000000000000000000000000000000000000000000000000000000 
00000000000000000000000000000000000000020000000000000000000000000000000000000000000000000000000000000000000000000000000000000000000000 
00000000022022000000000000022200000200020002000000000000000000000000000000000000000000000000000000000000000000000000000000000000000000 
00000000222022200022000222000000000200020002000000000000000000000000000000000000000000000000000000000000000000000000000000000000000000 
00000002222022220000000000000000000200020002000000000000000000000000000000000000000000000000000000000000000000000000000000000000000000 
22222222222022222222222222000222222200020002222222222222222222222222222222222222222222222222222222222222222222222222222222222222222222 